chapter=глава
down=вниз
rabbit-hole=к Кроличьей норе
alice=Алиса
was=была
beginning=начинать
get=становиться
very=очень
tired=уставшей
of=из-за
sitting=сидения
by=рядом с
her=ее
sister=сестра
on=на
bank=скамья
having=имея
nothing=ничего
do=делать
once=раз
or=или
twice=два
she=она
peeped=подсмотрела
into=в
book=книга
but=но
it=оно
had=имел
no=никаких
pictures=картинки
conversations=разговоры
and=и
reading=читать
to=ㅤ
the=ㅤ
in=в
